Pushbutton	KEYWORD1
QTRSensorsAnalog	KEYWORD1
QTRSensorsRC	KEYWORD1
QTRSensors	KEYWORD1
ZumoMotors	KEYWORD1
ZumoBuzzer	KEYWORD1
ZumoReflectanceSensorArray	KEYWORD1

waitForPress	KEYWORD2
waitForRelease	KEYWORD2
waitForButton	KEYWORD2
isPressed	KEYWORD2
getSingleDebouncedPress	KEYWORD2
getSingleDebouncedRelease	KEYWORD2
flipLeftMotor	KEYWORD2
flipRightMotor	KEYWORD2
setLeftSpeed	KEYWORD2
setRightSpeed	KEYWORD2
setSpeeds	KEYWORD2
read	KEYWORD2
emittersOff	KEYWORD2
emittersOn	KEYWORD2
calibrate	KEYWORD2
readCalibrated	KEYWORD2
readLine	KEYWORD2
calibratedMinimumOn	KEYWORD2
calibratedMaximumOn	KEYWORD2
calibratedMinimumOff	KEYWORD2
calibratedMaximumOff	KEYWORD2
init	KEYWORD2
playFrequency	KEYWORD2
playNote	KEYWORD2
play	KEYWORD2
playFromProgramSpace	KEYWORD2
isPlaying	KEYWORD2
stopPlaying	KEYWORD2
playMode	KEYWORD2
playCheck	KEYWORD2

ZUMO_BUTTON	LITERAL1
PULL_UP_DISABLED	LITERAL1
PULL_UP_ENABLED	LITERAL1
DEFAULT_STATE_LOW	LITERAL1
DEFAULT_STATE_HIGH	LITERAL1
QTR_EMITTERS_OFF	LITERAL1
QTR_EMITTERS_ON	LITERAL1
QTR_EMITTERS_ON_AND_OFF	LITERAL1
QTR_NO_EMITTER_PIN	LITERAL1
PLAY_AUTOMATIC	LITERAL1
PLAY_CHECK	LITERAL1
NOTE_C	LITERAL1
NOTE_C_SHARP	LITERAL1
NOTE_D_FLAT	LITERAL1
NOTE_D	LITERAL1
NOTE_D_SHARP	LITERAL1
NOTE_E_FLAT	LITERAL1
NOTE_E	LITERAL1
NOTE_F	LITERAL1
NOTE_F_SHARP	LITERAL1
NOTE_G_FLAT	LITERAL1
NOTE_G	LITERAL1
NOTE_G_SHARP	LITERAL1
NOTE_A_FLAT	LITERAL1
NOTE_A	LITERAL1
NOTE_A_SHARP	LITERAL1
NOTE_B_FLAT	LITERAL1
NOTE_B	LITERAL1
SILENT_NOTE	LITERAL1
DIV_BY_10	LITERAL1
